................
................
................
................
................
................
XXXXXXX X XXXXXX
.        .......
XXXXXXX X XXXXXX
................
................
................
................
................
................
................
