..................
................
... . OOOOO.....
. .. .O...O.....
......O.g.O.....
......O...O.....
 .....OOOOO.....
 XX ............
... . XXXXX.....
. .. .X...X.....
...... .g.X.....
......X...X.....
 .....XXXXX.....
................
................
................